椎体爆裂骨折	others	\N
苍耳中毒	others	\N
桡骨骨折	others	跌倒
慢性脓胸	respiratory_system	\N
高渗性脱水	cancer	\N
双分支阻滞	cardiovascular_cerebrovascular	\N
营养缺乏性神经病变	metabolic_system	\N
食管梅毒	others	\N
流行性感冒	respiratory_system	\N
迷路窗破裂	others	\N
心瘅	cardiovascular_cerebrovascular	\N
炭疽病	others	\N
胎膜早破	others	\N
伸指肌腱损伤	others	\N
斜颈	others	\N
巨细胞动脉炎和风湿性多肌痛	others	\N
脏躁	mental_disorder	\N
小儿骨与关节结核	others	\N
睾丸肿瘤	cancer	\N
血栓性血小板减少性紫癜	others	\N
原发性硬化性胆管炎	others	\N
非典型纤维黄色瘤	cancer	\N
小儿脊髓前动脉综合征	others	\N
食管过短	others	\N
肩关节周围炎	others	\N
羰基镍中毒	others	\N
隐睾	others	\N
蓝痣	others	\N
房性期前收缩	others	\N
疱疹样皮炎	cardiovascular_cerebrovascular	\N
肾性糖尿	metabolic_system	糖尿病
二水焦磷酸钙结晶沉积症	metabolic_system	\N
乙脑伴发的精神障碍	mental_disorder	\N
甲亢	metabolic_system	\N
前列腺脓肿	others	\N
槭糖尿病	metabolic_system	\N
视神经乳头水肿及视盘水肿	others	\N
毛囊脓疱病	others	\N
白细胞葡萄糖-6-磷酸脱氢酶缺乏症	metabolic_system	\N
视网膜后膜	others	\N
小儿心房扑动	cardiovascular_cerebrovascular	\N
药物过敏性口炎	others	\N
小儿狂犬病	others	\N
创伤性窒息	others	\N
上皮样囊肿	others	\N
肾上腺囊肿	others	\N
甲型H1N1流感	respiratory_system	\N
慢性胰腺炎	others	\N
变异性红斑角化病	others	\N
原发性卵巢类癌综合征	others	\N
寻常狼疮	metabolic_system	\N
小细胞低色素性贫血	others	\N
暴泻	others	\N
心脏损伤	cardiovascular_cerebrovascular	\N
乳头状腺瘤	cancer	\N
甲状腺结核	others	\N
小儿IgA肾病	others	\N
Marie-Bamberger综合征	respiratory_system	\N
支气管扩张	respiratory_system	\N
管状小汗腺癌	cancer	\N
阴道恶性苗勒管混合瘤	cancer	\N
藏毛囊肿	others	\N
脑型肺吸虫病	others	\N
乳腺囊性增生症	others	\N
视神经撕脱	others	\N
室间隔膜部瘤	cardiovascular_cerebrovascular	\N
内分泌性肌病	metabolic_system	\N
尿瘘	others	\N
先天性短食管	others	\N
踝关节骨折	others	\N
非典	respiratory_system	\N
真菌性脑膜炎	others	\N
小儿马方综合征	others	\N
髌腱断裂	others	\N
甲状旁腺功能亢进	others	\N
神经源性角膜炎	others	\N
脑瘤	cancer	\N
系统性红斑狼疮性巩膜炎	others	\N
返流性胆管炎	others	\N
慢性阿米巴性痢疾	others	\N
幼儿急疹	others	\N
腘血管陷迫综合征	others	\N
梅毒性葡萄膜炎	others	\N
前庭神经炎	others	\N
α1-抗胰蛋白酶缺乏症	others	\N
肌疝	others	\N
卵巢硬化性间质瘤	cancer	\N
感染性腹主动脉瘤	cardiovascular_cerebrovascular	\N
胆道肿瘤	cancer	\N
颈椎先天融合畸形	others	\N
心绞痛	cardiovascular_cerebrovascular	冠心病
肩峰骨折	others	\N
淋巴瘤	cancer	\N
结核性脊髓炎	others	\N
分流性高胆红素血症综合征	others	\N
呼吸道结核病	respiratory_system	\N
眼弓蛔虫病	others	\N
咽部神经鞘膜瘤	cancer	神经系统肿瘤
黏液性小汗腺癌	cancer	\N
小儿醛固酮过多症	metabolic_system	\N
混睛帐	others	\N
乳糜腹	others	\N
继发于无晶状体眼和人工晶状体眼的青光眼	others	\N
肺泡-毛细血管阻滞综合征	respiratory_system	\N
肝血管肉瘤	cancer	肝癌
新生儿低钠血症	metabolic_system	\N
妊娠合并缺铁性贫血	others	\N
慢性细菌性痢疾	others	\N
白喉性心肌炎	cardiovascular_cerebrovascular	\N
神经性皮炎	others	\N
共济失调	cardiovascular_cerebrovascular	\N
冠心病	cardiovascular_cerebrovascular	冠心病
小儿出血性疾病	others	\N
代谢综合征	metabolic_system	\N
α1抗胰蛋白酶缺乏性肝病	metabolic_system	\N
十二指肠静脉曲张	others	\N
缺铁性贫血	others	\N
脊索瘤	cancer	\N
急性闭角性青光眼	others	\N
肠道菌群失调症	others	\N
上隐斜	others	\N
肾钙乳	others	\N
毛鞘棘皮瘤	others	\N
卵巢支持-间质细胞瘤	cancer	\N
温虐	others	\N
鼻部脑膜脑膨出	cardiovascular_cerebrovascular	\N
外阴-阴道-牙龈综合征	others	\N
梅克尔憩室	others	\N
恶性小汗腺汗孔瘤	cancer	\N
暴发性紫癜	metabolic_system	\N
颅内低压性头痛	cardiovascular_cerebrovascular	\N
单眼双下转肌麻痹	cardiovascular_cerebrovascular	\N
口腔颌面部血管瘤	cardiovascular_cerebrovascular	\N
急性单纯外伤性腰腿痛	others	\N
阳明头痛	cardiovascular_cerebrovascular	\N
杀虫脒中毒	others	\N
肠气囊肿	others	\N
家族性混合型高脂血症	metabolic_system	血脂异常
咽部创伤	others	\N
肾下垂	others	\N
腱鞘囊肿	others	\N
红斑狼疮	metabolic_system	\N
继发性皮肤滤泡中心细胞性淋巴瘤	cancer	\N
腭裂	others	\N
哨兵痔	others	\N
晕厥	cardiovascular_cerebrovascular	\N
喉外伤	others	\N
埃布斯坦综合征	cardiovascular_cerebrovascular	\N
热痹	others	\N
过敏性紫癜肾炎	metabolic_system	\N
急性宫颈炎	others	\N
出血性休克和脑病综合征	others	\N
隐翅虫皮炎	others	\N
嘧啶5′-核苷酸缺乏症	metabolic_system	\N
稳定型心绞痛	cardiovascular_cerebrovascular	冠心病
糖尿病	metabolic_system	糖尿病
短颈畸形	others	\N
小儿史-约综合征	others	\N
小儿过敏性紫癜	metabolic_system	\N
范科尼综合征	metabolic_system	\N
二期梅毒	others	\N
小汗腺汗管纤维腺瘤	cancer	\N
经腹会阴直肠癌根治术后盆底腹膜疝	others	\N
社交恐惧症	mental_disorder	\N
粉碎性骨折	others	\N
朗格汉斯细胞组织细胞增生症	cancer	\N
腹壁挫伤	others	\N
卵巢黄体囊肿破裂	others	\N
急性化脓性关节炎	others	\N
幽门螺杆菌感染	others	\N
痰热咳嗽	respiratory_system	\N
食管损伤	others	\N
加速性室性自主心律	cardiovascular_cerebrovascular	\N
流行性角膜结膜炎	others	\N
肺部钩虫病	respiratory_system	\N
轻链病与轻链沉积病	others	\N
老年人骨关节炎	metabolic_system	\N
睾丸鞘膜积液	others	\N
直肠息肉	others	\N
水痘-带状疱疹性葡萄膜炎	others	\N
生殖道肿瘤	cancer	\N
小儿颅咽管瘤	cancer	\N
反分化软骨肉瘤	cancer	\N
弥漫性血管内凝血	metabolic_system	\N
荨麻疹和血管性水肿	others	\N
脊疳	others	\N
眼眶脑膜-脑膨出	cardiovascular_cerebrovascular	\N
阻塞性睡眠呼吸暂停综合征	respiratory_system	\N
植物神经系统肿瘤	cancer	神经系统肿瘤
前列腺病	others	\N
小儿急性偏瘫	cardiovascular_cerebrovascular	\N
生理性卵巢囊肿	others	\N
胰岛素瘤	cancer	胰腺癌
小肠系膜损伤	others	\N
髓性多汗症	others	\N
肛窦炎及肛乳头炎	others	\N
耳外伤	others	\N
溃疡病大出血	others	\N
青年性驼背	others	\N
眼眶静脉性血管瘤	others	\N
舌下腺囊肿	others	\N
甲醛中毒	others	\N
动脉硬化性闭塞症	cardiovascular_cerebrovascular	\N
先天性巨细胞包涵体病	others	\N
皮下脂肪瘤	cancer	\N
蹄铁形肾	others	\N
玻璃体混浊	others	\N
眼眶神经鞘瘤	cancer	神经系统肿瘤
卵巢纤维瘤	cancer	\N
骨髓增生性疾病	others	\N
须部假毛囊炎	others	\N
膀胱与尿道结石	others	\N
先天性肌强直	others	\N
水痘性角膜炎	others	\N
老年人血管性痴呆	mental_disorder	阿尔兹海默症
肩-手综合征	others	\N
腹部创伤	others	\N
躁狂症	mental_disorder	\N
全身性发疹性组织细胞增生症	others	\N
高血压脑出血	cardiovascular_cerebrovascular	高血压
其他病毒肺炎	respiratory_system	\N
继发于严重肝疾患的棘红细胞增多症	others	\N
克罗恩病	others	\N
急性淋巴细胞白血病	cancer	\N
持续性枕横位难产	others	\N
房室交接区逸搏和逸搏心律	cardiovascular_cerebrovascular	\N
Leber遗传性视神经病变	cardiovascular_cerebrovascular	\N
小儿肾病综合征	metabolic_system	\N
呼吸性碱中毒	respiratory_system	\N
小儿结节性硬化症	metabolic_system	\N
颈部淋巴结结核	others	\N
空肠、回肠憩室	others	\N
新生儿生理性黄疸	metabolic_system	\N
乳发	others	\N
突发性耳聋	others	\N
睑板腺囊肿	others	\N
小儿急性小脑性共济失调	cardiovascular_cerebrovascular	\N
脑鸣	cardiovascular_cerebrovascular	\N
老年人稳定型心绞痛	cardiovascular_cerebrovascular	冠心病
着色杆菌病	others	\N
纵隔非霍奇金恶性淋巴肿瘤	cancer	\N
咽异感症	others	\N
妊娠合并红细胞增多症	others	\N
老年人膀胱癌	cancer	\N
膝关节韧带损伤	others	\N
胰腺脑病综合征	others	\N
咽角化症	others	\N
肠道厌氧菌感染	others	\N
腰痛-血尿综合征	others	\N
下部附加前根脊髓动脉缺血症候群	cardiovascular_cerebrovascular	\N
皮肤白细胞破碎性血管炎	others	\N
乳酸性酸中毒	metabolic_system	\N
副霍乱	others	\N
皮肤癣菌病	others	\N
葡萄糖-6-磷酸脱氢酶缺乏症	others	\N
巨细胞病毒性肺炎	respiratory_system	\N
胚胎遗留性囊肿	others	\N
肥胖性生殖无能综合征	others	\N
肩关节结核	others	\N
胆源性慢性胰腺炎	others	\N
恋物癖	others	\N
挛痹	others	\N
先天性小肠闭锁和肠狭窄	others	\N
冻疮	others	\N
脑癌	cancer	\N
先天性视网膜劈裂症	others	\N
肠杆菌肺炎	respiratory_system	\N
尿精	others	\N
胃结核	others	\N
小肠平滑肌肉瘤	cancer	\N
湿热痢	others	\N
酒中毒性周围神经病	cardiovascular_cerebrovascular	\N
小儿哮喘	others	\N
颞下颌关节脱位	others	\N
眶假瘤	others	\N
人工关节置换术后关节感染	others	\N
妊娠合并甲亢	metabolic_system	\N
乳头的乳头状瘤	cancer	\N
遗传性高尿酸血症	metabolic_system	\N
克拉伯病	metabolic_system	\N
体质性低血压	cardiovascular_cerebrovascular	\N
脂肪肉瘤	cancer	\N
类脂性肺炎	respiratory_system	\N
上颈椎不稳症	others	\N
念珠状红苔藓	others	\N
黑色素瘤	cancer	\N
延迟性应激反应	mental_disorder	\N
蛛网膜炎	others	\N
小儿咽喉炎	respiratory_system	\N
薄肾小球基底膜病	metabolic_system	\N
肾功能不全	metabolic_system	\N
高度近视	others	\N
牙斑	others	\N
急性气管－支气管炎	respiratory_system	\N
男性尿道癌	cancer	\N
婴幼儿阴道炎	others	\N
瘢痕性脱发	others	\N
副肿瘤性斜视性眼肌阵挛-肌阵挛	cancer	\N
小肠原发性恶性淋巴瘤	cancer	\N
急性肾小管坏死	metabolic_system	\N
老年人急进性肾炎	metabolic_system	\N
烧伤后急性肾功能衰竭	metabolic_system	\N
习惯性便秘	others	\N
头痛	cardiovascular_cerebrovascular	\N
腹腔脓肿	others	\N
龋齿	others	\N
阵发性室性心动过速	cardiovascular_cerebrovascular	\N
间充质软骨肉瘤	cancer	\N
血吸虫尾蚴性皮炎	others	\N
梅毒	others	\N
排卵障碍	others	\N
小儿卡斯钦-贝克病	others	\N
小儿髓母细胞瘤	cancer	\N
小儿有机磷农药中毒	others	\N
小儿乳糜泻	others	\N
小儿真菌感染性口炎	others	\N
腹壁间疝	others	\N
学习技能发育障碍	mental_disorder	\N
喉喑	cancer	\N
喘息样支气管炎	cancer	\N
原发性血小板增多症	others	\N
狐惑	others	\N
妊娠高血压疾病	cardiovascular_cerebrovascular	\N
小儿颅后窝室管膜瘤	cancer	\N
巨大肥厚性胃炎	others	\N
结肠癌	cancer	结直肠癌
阑尾腺癌	cancer	\N
汉德-许勒尔-克思斯琴病	others	\N
膀胱憩室	others	\N
脾水	others	\N
蛔虫病	others	\N
淋巴结核	others	\N
心脑血管疾病	cardiovascular_cerebrovascular	\N
外阴银屑病	others	\N
盆腔脓肿	others	\N
小儿葡萄状肉瘤	cancer	\N
舟骨骨折	others	\N
中性粒细胞增多症	others	\N
新生儿晚期代谢性酸中毒	others	\N
小儿亚硝酸盐中毒	others	\N
生殖器念珠菌病	others	\N
紫癜性扁平苔藓	others	\N
偏执狂	mental_disorder	\N
蟹睛	others	\N
柏哲病	cancer	\N
发芽马铃薯中毒	others	\N
急性化脓性脊髓炎	others	\N
先天性纯红细胞再生障碍性贫血	others	\N
小儿两性畸形	others	\N
心气虚	cardiovascular_cerebrovascular	\N
加利福尼亚脑炎	cardiovascular_cerebrovascular	\N
链球菌中毒性休克综合征	others	\N
急性出血性坏死性肠炎	others	\N
网状红斑萎缩性毛囊炎	others	\N
小儿先天性巨结肠	others	\N
肺爆震伤	respiratory_system	\N
神经莱姆病	others	\N
角膜擦伤	others	\N
旋转带肌腱炎	others	\N
急性粒细胞缺乏	others	\N
穿透性心脏外伤	cardiovascular_cerebrovascular	\N
小儿喉痉挛	respiratory_system	\N
骨与关节结核	others	\N
莱姆心脏炎	cardiovascular_cerebrovascular	\N
牙源性皮瘘	others	\N
妊娠合并宫颈癌	cancer	\N
慢性腰部劳损	others	\N
阴道横隔	others	\N
赤丝虬脉	others	\N
流痰	others	\N
原发性单克隆免疫球蛋白病	others	\N
骨瘤	cancer	\N
骨纤维肉瘤	cancer	\N
孤独症谱系障碍	mental_disorder	\N
扭转痉挛	others	\N
子宫颈残端癌	cancer	宫颈癌
胎死不下	others	\N
牙隐裂	others	\N
慢性纤维性甲状腺炎	metabolic_system	\N
跖骨疲劳性骨折	others	\N
浅表性静脉炎	others	\N
外阴丹毒	others	\N
妊娠合并再生障碍性贫血	others	\N
背部弹力纤维瘤	others	\N
伪聋	others	\N
尿布疹	others	\N
狐臭	others	\N
巴德-吉亚利综合征	cardiovascular_cerebrovascular	\N
泪腺肉样瘤病	cancer	\N
食管异位组织	others	\N
急性咽炎	respiratory_system	\N
痛风性关节炎	others	\N
窦性心律失常	cardiovascular_cerebrovascular	\N
皮炎	others	\N
老年人急性呼吸窘迫综合征	respiratory_system	\N
淋巴瘤引起的肾损害	cancer	\N
急性泪囊炎	others	\N
癫痫伴发的精神障碍	mental_disorder	\N
小儿肾性氨基酸尿症	metabolic_system	\N
黏膜相关样组织淋巴瘤	cancer	\N
急性风湿热肾损害	metabolic_system	\N
外阴血吸虫病	others	\N
心源性哮喘	cardiovascular_cerebrovascular	\N
晕动病	cardiovascular_cerebrovascular	\N
侵袭性大肠埃希氏菌肠炎	others	\N
小儿神经源性膀胱	others	\N
肺癌肝转移	cancer	肺癌
产后泌尿道感染	others	\N
肱骨外髁颈骨折	others	\N
心源性休克	cardiovascular_cerebrovascular	\N
老年人肝硬化	others	\N
结缔组织增生性毛发上皮瘤	cancer	\N
甲状腺炎	metabolic_system	\N
螨皮炎	others	\N
死精症	others	\N
幼年黑素瘤	cancer	\N
多发性消化道息肉综合征	others	\N
肌筋膜炎	others	\N
肠道传染病	others	\N
再生障碍性贫血	others	\N
骨膜性软骨瘤	cancer	\N
小儿囊性纤维性变	others	\N
重度脂肪肝	others	\N
尿黑酸尿与褐黄病	metabolic_system	\N
小儿家族性嗅神经-性发育不全综合征	others	\N
甲状腺弥漫性病变	metabolic_system	\N
乙醚中毒	others	\N
红癣	others	\N
小儿热疮	others	\N
原发性婴幼儿型青光眼	others	\N
褥疮	others	\N
小儿曼氏迭宫绦虫病和曼氏裂头蚴病	others	\N
小儿石膏综合征	others	\N
强酸、强碱中毒	others	\N
肺部真菌感染	respiratory_system	\N
牙病	others	\N
小儿尼曼-皮克病	metabolic_system	\N
洁癖	mental_disorder	\N
肾小管性酸中毒	metabolic_system	\N
寄生虫性尿路感染	others	\N
亚急性甲状腺炎	metabolic_system	\N
新生儿尿布皮炎	others	\N
丹痧	others	\N
下疳样脓皮病	others	\N
新生儿消化道重复症	others	\N
躯体形式障碍	others	\N
小儿纤维性骨营养不良综合征	metabolic_system	\N
窦室传导	cardiovascular_cerebrovascular	\N
Stargardt病	others	\N
遗传性血管性水肿	others	\N
结节性血管炎	others	\N
玻璃体及视网膜脱离手术所致青光眼	others	\N
小儿血管角质瘤综合征	cancer	\N
内脏动脉慢性闭塞	others	\N
卡氏肺囊虫肺炎	respiratory_system	\N
异物伤	others	\N
乳房纤维瘤	others	\N
遗传性出血性毛细血管扩张症	others	\N
Ⅲ型超敏反应性疾病	others	\N
脾功能亢进症	others	\N
脊椎化脓性骨髓炎	others	\N
中毒性休克综合征	others	\N
鼻神经胶质瘤	others	\N
外源性变应性肺泡炎	respiratory_system	\N
锁骨下动脉-腋动脉瘤	cardiovascular_cerebrovascular	\N
脉络膜炎	others	\N
急性骨髓性白血病	cancer	\N
正常颅压脑积水	cardiovascular_cerebrovascular	\N
尿道肉阜	others	\N
亚急性联合变性	metabolic_system	\N
痰火扰心	cardiovascular_cerebrovascular	\N
鼻前颅底肿瘤	cancer	\N
小儿脑膜瘤	cancer	\N
心脏骤停与心肺脑复苏	cardiovascular_cerebrovascular	\N
老年人胆石症	others	\N
脑膜炎奈瑟菌肺炎	respiratory_system	\N
胃内异物	others	\N
慢性酒中毒	others	\N
烧伤	others	\N
鼻中隔偏曲	others	\N
脊椎结核后突畸形	others	\N
肱动脉损伤	cardiovascular_cerebrovascular	\N
寄生虫性关节炎	others	\N
Usher综合征	others	\N
鳃裂囊肿和瘘管	others	\N
上睑下垂	others	\N
五脏痹	others	\N
极外侧型腰椎间盘突出症	others	\N
胆道出血	others	\N
触电	others	\N
垂体卒中	cardiovascular_cerebrovascular	卒中
老年人心房扑动	cardiovascular_cerebrovascular	\N
脊柱、脊髓损伤	others	\N
牙外伤	others	\N
免疫性不孕	others	\N
小儿便秘	others	\N
静脉炎	others	\N
慢性牙周炎	others	\N
干呕	others	\N
反应性组织细胞增多症	others	\N
胃类癌瘤	cancer	神经系统瘤
老年性癫痫	mental_disorder	\N
口腔干燥综合征	metabolic_system	\N
直立性低血压	cardiovascular_cerebrovascular	\N
立氏立克次体斑疹热	others	\N
冬眠瘤	cancer	\N
四肢不用	others	\N
妊娠纹	others	\N
全身脂肪代谢障碍	metabolic_system	\N
中心性软骨肉瘤	cancer	\N
膝关节内侧副韧带断裂	others	\N
食管白斑	others	\N
透明细胞软骨肉瘤	cancer	\N
外阴色素痣	others	\N
无排卵型功能失调性子宫出血	others	\N
恋童癖	mental_disorder	\N
眼眶平滑肌瘤	cancer	\N
难治性心力衰竭	cardiovascular_cerebrovascular	\N
